F 139,99,58
C 171,154,137

NO ./assets/bricks/grey.png
SO ./assets/bricks/blue.png
WE ./assets/bricks/yellow.png
EA ./assets/bricks/purple.png
DO ./assets/funny/soink.png

1111111111111111111
1001001001001001001
1001001001001001001
1001001001001001001
1001001000001001001
1000000101000000001
10000001D1000000001
1111111101111111111
1E00000000000000001
1111111111111111111
