F 139,99,58
C 171,154,137

NO ./assets/grey.png
SO ./assets/blue.png
WE ./assets/yellow.png
EA ./assets/purple.png
DO ./assets/soink.png

1111111111111111111
1001001001001001001
1001001001001001001
1001001001001001001
1001001000001001001
1000000000000000001
1000011111111000001
11110000D0000001111
1E00000101010000001
1111111111111111111
